,,,,,,,---
,---------
,-~,,,,---
,-,~,,-,-,
,-,,~-,,-,
,-,,-~,,-,
,-,-,,~,-,
---,,,,~-,
---------,
---,,,,,,,

