..........
........R.
..........
...d..r...
..........
..........
...b..n...
..........
.B........
..........