*~~~~~~~~~
~~~~~~~~~~
~*~~~~~~~~
~~~~~~~~~~
~~~~~~~~~~
~~~~~~~~~~
~*~*~~~~~~
~~~*~~~~~~
~~~*~~~~~~
~~~~~~~~~~