~~~~~~~*~~
~~~~~~**~~
~~~*~~~***
~**~**~~~~
~~~|~~**~~
~****|*~**
**~~~~~~~~
~~~~~|~***
~~~~~~~~~~
~~~~~~~~~~