~~**~~~*~~
~~~*~~**~~
~~~*~~~***
~**~**~~~~
~~~|~~**~~
~****|*~**
**~~||~~~~
~~~~~|~***
~~~~~~~~~~
~~~~~~~~~~